                                         
 # ### #### #      # # $  ### # # # #  
 ###   # #### ###### ### ###### ####### 
   #######     #######    ########## 
      #          #            #
      #          #            #
      #          #            #
      #          ##############
      #          #            #
      #          #            #
      #########################
                      #
                                
 
 
                                          
 # ### #### #      # # $  ### # # # #  
 ###   # #### ###### ### ###### ####### 
   #######     #######    ########## 
      #          #            #
      #          #            #
      #          #            #
      #          ##############
      #          #            #
      #          #            #
      #########################
                      #
                                
 
