                                                        
        #########        ###########      #       #     
          ###################             #########   
          #        #    #   #             #   #       
          #        #    #   #             #   #     
          #        #   #$####     #############    
          #        #    #   #     #           # 
          #        ##########     #        #####   
          #        #        #     #        # #     
          #        #        ################     
          #        #        #    # #           
          ###################    ###           
                                                  
